111111111111111111111111111111
110100101000000000100000000001
101E10000010000010000000000001
11000001C011000000000001010001
1000100C0000100100000000000001
100000001000000000100000001011
1C100000010000C000000000000011
100000000000000000000000000011
1100C0101010000000000000000011
101000000000000000010000001001
100000000000000001000000010001
100000000000000100000010000001
100000000000000000100000000001
100000000000000000000000000001
100001010000010100000000000C11
1000000C00000010000000C0100001
10000000001000000C000010000001
100000011010000010010000000P01
100010000100000000100000000001
10000000000000C0001100000000C1
100011100001100000000000000001
100011111111100000000000000001
100000111101000000001000000011
111111111111111111111111111111