1111111111111111111111111111111111111
1000000000000000000000000000000000001
1000000000000111111101111111111111111
1000000000111111110001111000111111111
1000000011111110000001000000111111111
10000111111110000P0000000000111111101
1001111111C00000000000000111111110001
10111111C0000000000000011111110000001
101111CCCCCCC0CCCCCC01111111000000001
1011111111111111111101111111000001111
1011111111111111111101111111000111111
1000000000000111111101111111011111111
10000000000001111111000CCC00000000001
100000000000011111110E0C0CC0000000001
1111111111111111111111111111111111111