11111111111111111111111111111
110100101000000111111111111111
100E00000010001111111111000111
11000000C011001111110111100011
1000100C0001101111110001111111
100000000011100001100000111111
1C000000011100C000000000011111
100000000000000000000000001111
1100C0001010000000000000000111
101000000000000000010000001001
100000000000000001000000010001
100000000000000100000000000001
100000000000000000100000000001
100000000000000000000000000001
100001010000010100000000000C11
1000000C00000010000000C0000001
10000000001000000C000010000001
1000000110100000111111111P0001
100010000100000001111111100001
10000000000000C0011000011000C1
10001110000110000110M001100001
100011111111100001100001100001
100000111101000001111111100011
111111111111111111111111111111