111111111111111111111111111111
110100101000000111111111111111
100E00000010001111111111000111
11000000C011001111110111100011
1000100C0001101111110001111111
100000000011100001100000111111
1C000000011100C000000000011111
10000000000MMMMMMMMMMMMMM01111
1100C0001010000000000000000111
101M00000000000000010000001001
100M00000000000001000000010001
100M00000000000100000000000001
100M00000000000000100000000001
100M00000000000000000000000001
100M01010000010100000000000C11
100M000C00000010000000C0000001
100M0000001000M00C000010000001
100M000110100000111111111P0001
100M1000010000M001111111100001
100M0000000000C0011000011000C1
10001110000110000110M001100001
100011111111100001100001100001
100000111101000001111111100011
111111111111111111111111111111