1111111111111111
1111111100000111
11100010000000C1
1100000000000001
1000000011111001
1100P0011E000001
1111111111111111
1111111111111111
