1111111111111111111111111111111111
1E0000000000000C00000C000000000001
1000000000000000000000000001100001
1000111110011110001110000001110001
1000000010010000001111100000110001
1P0000001C01C0001111011100000000C1
1111111111111111111111111111111111
