1111111111111111111111
1E000000000000000000P1
1111100000000111111111
1000100000C000000C0001
1100110011111100110011
1000000000000000000001
1MMMMMMMMMMMMMMMMMMMM1
1111111111111111111111
