11111111111
10000000001
100C0E0P001
10000000001
11111111111
